........#.
#.......#.
.##....##.
..........
...###....
...###....
..........
.##....##.
.#.......#
.#........