@@@@##@@@@
@@@@@#@@@@
@#@@@@#@@@
@@####@@@@
@#@@@@@@@@
@@@####@#@
@@#@@@#@@@
@@@@@@@@@@
@#@@#@@@#@
@@@@@@@@@@