@@@@##@@@@
@@@@@#@@@@
@#@@@@#@@@
@@@###@@@@
@#@@@@@@@@
@@@###@@#@
@@#@@@#@@@
@@@@@@@@@@
@#@@#@@@#@
@@@@@@@@@@