@@@@#@@@@@
@#@@#@#@@@
@@@@@@#@#@
@#@@#@#@@@
@@@#@@@#@@
#@@@@@#@@@
@@@#@#@@@@
@@@#@#@@#@
@#@#@@@@@@
@@@@@#@@@@