@@@@@#@@@@
#@#@@@#@@@
@@@@#@@@@@
#@@#@@@@#@
@@#@@@@@#@
@@@@##@@@@
#@@#@@@#@@
@@@@@@@##@
@@@@#@@@@@
@@@@@@@#@@